11111111111111111111111111111111111
1P000000000000000000000000000000001
100000000000000000000000000000C0001
10000000000000000000000000000000001
10000000000000000001111111111111111
10000000000000000000000000C00000001
1001111111100000000000000000E000001
10000000000000000000000000000000001
10000000000000000000000000000000001
11111111111111111111111111111111111