1111111111111111111111111111111111
10000000000000C00000C0000000000001
1010010100100000101001000000010101
101001001011101000C001000000010111
1P0000000C01C00001E1000000000000C1
1111111111111111111111111111111111