
//pas valable
1111111
0100001
1000001
1111111

//pas valable
111
101
111

/pas valable
111
1P1
1E1
111


//valable 
111
1E1
1P1
1C1
111
